############
############
############
############
####  ######
####   @####
#### $. ####
#####   ####
############
############
############
############
