############
############
############
###  #######
###     ####
### ##   ###
##. .# @$###
##   # $$ ##
##  .#    ##
############
############
############
