############
############
####   #####
####*$@#####
### .*$   ##
###  .*$  ##
#### #. ####
####    ####
############
############
############
############
