############
##### ..@###
##### $$ ###
###### #####
###### #####
###### #####
###### #####
###    #####
### #   ####
###   # ####
#####   ####
############