############
#          #
#  .       #
#   .....  #
#   .....  #
#   .....  #
#   .....  #
#@$ .....  #
#          #
#    *   * #
#          #
############
