############
###   ######
### # ######
##@      ###
##   # #   #
## # # $ # #
##   ##    #
## #    ####
##.  #   ###
###### # ###
######   ###
############