############
############
############
####     ###
#### .$. ###
#### $@$ ###
###  .$. ###
###      ###
############
############
############
############