############
############
############
####    ####
#### $ $####
#### #@$ ###
####   # ###
##### .. ###
#####  .####
############
############
############
