#####  #####
#####@     #
####   ##  #
 ..# # ## ##
     $  #$##
#  # #    ##
####   ##$##
#########  #
####.      #
########## #
########.$ #
############
