############
############
############
############
####  ######
####  $@####
#### *. ####
#####   ####
############
############
############
############